3202 3202 3202 3202 3202 3202 3202 3202 3202 3202 3202 3202 3202 3202 3202 3202 3202 3202 3202 3202 3202 3202 3202 3202 3202 3202 3202 3202 3202 3202 3202 3202 3202 3202 3202 3202 3202 3202 3202 3202 3202 3202 3202 3202 3202 3202 3202 3202 3202 3202 3202 3202 3202 3202 3202 3202 3202 3202 3202 3202 3202 3202 3202 3202 3202 3202 3202 3202 
3202 3202 3202 3202 3202 3202 3202 3202 3202 3202 3202 3202 3202 3202 3202 3202 3202 3202 3202 3202 3202 3202 3202 3202 3202 3202 3202 3202 3202 3202 3202 3202 3202 3202 3202 3202 3202 3202 3202 3202 3202 3202 3202 3202 3202 3202 3202 3202 3202 3202 3202 3202 3202 3202 3202 3202 3202 3202 3202 3202 3202 3202 3202 3202 3202 3202 3202 3202 
3202 3202 3202 3202 3202 3202 3202 3202 3202 3202 3202 3202 3202 3202 3202 3202 3202 3202 3202 3202 3202 3202 3202 3202 3202 3202 3202 3202 3202 3202 3202 3202 3202 3202 3202 3202 3202 3202 3202 3202 3202 3202 3202 3202 3202 3202 3202 3202 3202 3202 3202 3202 3202 3202 3202 3202 3202 3202 3202 3202 3202 3202 3202 3202 3202 3202 3202 3202 
3202 3202 3202 3202 3202 3202 3202 3202 3202 3202 3202 3202 3202 3202 3202 3202 3202 3202 3202 3202 3202 3202 3202 3202 3202 3202 3202 3202 3202 3202 3202 3202 3202 3202 3202 3202 3202 3202 3202 3202 3202 3202 3202 3202 3202 3202 3202 3202 3202 3202 3202 3202 3202 3202 3202 3202 3202 3202 3202 3202 3202 3202 3202 3202 3202 3202 3202 3202 
3202 3202 3202 3202 3202 3202 3202 3202 3202 3202 3202 3202 3202 3202 3202 3202 3202 3202 3202 3202 3202 3202 3202 3202 3202 3202 3202 3202 3202 3202 3202 3202 3202 3202 3202 3202 3202 3202 3202 3202 3202 3202 3202 3202 3202 3202 3202 3202 3202 3202 3202 3202 3202 3202 3202 3202 3202 3202 3202 3202 3202 3202 3202 3202 3202 3202 3202 3202 
3202 3202 3202 3202 3202 3202 3202 3202 3202 3202 3202 3202 3202 3202 3202 3202 3202 3202 3202 3202 3202 3202 3202 3202 3202 3202 3202 3202 3202 3202 3202 3202 3202 3202 3202 3202 3202 3202 3202 3202 3202 3202 3202 3202 3202 3202 3202 3202 3202 3202 3202 3202 3202 3202 3202 3202 3202 3202 3202 3202 3202 3202 3202 3202 3202 3202 3202 3202 
3202 3202 3202 3202 3202 3202 3202 3202 3202 3202 3202 3202 3202 3202 3202 3202 3202 3202 3202 3202 3202 3202 3202 3202 3202 3202 3202 3202 3202 3202 3202 3202 3202 3202 3202 3202 3202 3202 3202 3202 3202 3202 3202 3202 3202 3202 3202 3202 3202 3202 3202 3202 3202 3202 3202 3202 3202 3202 3202 3202 3202 3202 3202 3202 3202 3202 3202 3202 
3202 3202 3202 3202 3202 3202 3202 3202 3202 3202 3202 3202 3202 3202 3202 3202 3202 3202 3202 3202 3202 3202 3202 3202 3202 3202 3202 3202 3202 3202 3202 3202 3202 3202 3202 3202 3202 3202 3202 3202 3202 3202 3202 3202 3202 3202 3202 3202 3202 3202 3202 3202 3202 3202 3202 3202 3202 3202 3202 3202 3202 3202 3202 3202 3202 3202 3202 3202 
3202 3202 3202 3202 3202 3202 3202 3202 3202 3202 3202 3202 3202 3202 3202 3202 3202 3202 3202 3202 3202 3202 3202 3202 3202 3202 3202 3202 3202 3202 3202 3202 3202 3202 3202 3202 3202 3202 3202 3202 3202 3202 3202 3202 3202 3202 3202 3202 3202 3202 3202 3202 3202 3202 3202 3202 3202 3202 3202 3202 3202 3202 3202 3202 3202 3202 3202 3202 
3202 3202 3202 3202 3202 3202 3202 3202 3202 3202 3202 3202 3202 3202 3202 3202 3202 3202 3202 3202 3202 3202 3202 3202 3202 3202 3202 3202 3202 3202 3202 3202 3202 3202 3202 3202 3202 3202 3202 3202 3202 3202 3202 3202 3202 3202 3202 3202 3202 3202 3202 3202 3202 3202 3202 3202 3202 3202 3202 3202 3202 3202 3202 3202 3202 3202 3202 3202 
3202 3202 3202 3202 3202 3202 3202 3202 3202 3202 3202 3202 3202 3202 3202 3202 3202 3202 3202 3202 3202 3202 3202 3202 3202 3202 3202 3202 3202 3202 3202 3202 3202 3202 3202 3202 3202 3202 3202 3202 3202 3202 3202 3202 3202 3202 3202 3202 3202 3202 3202 3202 3202 3202 3202 3202 3202 3202 3202 3202 3202 3202 3202 3202 3202 3202 3202 3202
3202 3202 3202 3202 3202 3202 3202 3202 3202 3202 3202 3202 3202 3202 3202 3202 3202 3200 3200 4001 4002 4003 4004 4005 4006 4007 4008 4009 4010 4011 4012 4013 4014 4015 4016 4017 4018 4019 4020 4021 4022 4023 4024 4025 3200 4027 4028 4029 3200 3200 3200 3202 3202 3202 3202 3202 3202 3202 3202 3202 3202 3202 3202 3202 3202 3202 3202 3202
3202 3202 3202 3202 3202 3202 3202 3202 3202 3202 3202 3202 3202 3202 3202 3202 3202 3200 3200 4101 4102 4103 4104 4105 4106 4107 4108 4109 4110 4111 4112 4113 4114 4115 4116 4117 4118 4119 4120 4121 4122 4123 4124 4125 4126 4127 4128 4129 4130 3200 3200 3202 3202 3202 3202 3202 3202 3202 3202 3202 3202 3202 3202 3202 3202 3202 3202 3202
3202 3202 3202 3202 3202 3202 3202 3202 3202 3202 3202 3202 3202 3202 3202 3202 3202 3200 3200 4201 4202 4203 4204 4205 4206 4207 4208 4209 4210 4211 4212 4213 4214 4215 4216 4217 4218 4219 4220 4221 4222 4223 4224 4225 4226 4227 4228 4229 4230 3200 3200 3202 3202 3202 3202 3202 3202 3202 3202 3202 3202 3202 3202 3202 3202 3202 3202 3202
3202 3202 3202 3202 3202 3202 3202 3202 3202 3202 3202 3202 3202 3202 3202 3202 3202 3200 3200 4301 4302 4303 4304 4305 4306 4307 4308 4309 4310 4311 4312 4313 4314 4315 4316 4317 4318 4319 4320 4321 4322 4323 4324 4325 4326 4327 4328 4329 4330 3200 3200 3202 3202 3202 3202 3202 3202 3202 3202 3202 3202 3202 3202 3202 3202 3202 3202 3202
3202 3202 3202 3202 3202 3202 3202 3202 3202 3202 3202 3202 3202 3202 3202 3202 3202 3200 3200 4401 4402 4403 4404 4405 4406 4407 4408 4409 4410 4411 4412 4413 4414 4415 4416 4417 4418 4419 4420 4421 4422 4423 4424 4425 4426 4427 3202 4429 4430 3200 3200 3202 3202 3202 3202 3202 3202 3202 3202 3202 3202 3202 3202 3202 3202 3202 3202 3202
3202 3202 3202 3202 3202 3202 3202 3202 3202 3202 3202 3202 3202 3202 3202 3202 3202 3200 3200 4501 4502 4503 4504 4505 4506 4507 4508 4509 4510 4511 4512 4513 4514 4515 4516 4517 4518 4519 4520 4521 4522 4523 4524 3200 3202 3202 3202 3202 3202 3200 3200 3202 3202 3202 3202 3202 3202 3202 3202 3202 3202 3202 3202 3202 3202 3202 3202 3202
3202 3202 3202 3202 3202 3202 3202 3202 3202 3202 3202 3202 3202 3202 3202 3202 3202 3200 3200 3202 3202 3202 3202 3202 3202 3202 3202 3202 3202 3202 3202 3202 3202 3202 3202 3202 3202 3202 3202 3202 3202 3202 3202 3200 3202 3202 3202 3202 3202 3200 3200 3202 3202 3202 3202 3202 3202 3202 3202 3202 3202 3202 3202 3202 3202 3202 3202 3202
3202 3202 3202 3202 3202 3202 3202 3202 3202 3202 3202 3202 3202 3202 3202 3202 3202 3200 3200 3202 3202 3202 3202 3202 3202 3202 3202 3202 3202 3202 3202 3202 3202 3202 3202 3202 3202 3202 3202 3202 3202 3202 3202 3200 3202 3202 3202 3202 3202 3200 3200 3202 3202 3202 3202 3202 3202 3202 3202 3202 3202 3202 3202 3202 3202 3202 3202 3202
3202 3202 3202 3202 3202 3202 3202 3202 3202 3202 3202 3202 3202 3202 3202 3202 3202 3200 3200 3202 3202 3202 3202 3202 3202 3202 3202 3202 3202 3202 3202 3202 3202 3202 3202 3202 3202 3202 3202 3202 3202 3202 3202 3202 3202 3202 3202 3202 3202 3200 3200 3202 3202 3202 3202 3202 3202 3202 3202 3202 3202 3202 3202 3202 3202 3202 3202 3202
3202 3202 3202 3202 3202 3202 3202 3202 3202 3202 3202 3202 3202 3202 3202 3202 3202 3200 3200 4901 4902 4903 4904 4905 4906 4907 3200 3202 3202 3202 3202 3202 3200 3202 3202 3202 3202 3202 3202 3202 3202 3202 3202 3202 3202 3202 3202 3202 3202 3200 3200 3202 3202 3202 3202 3202 3202 3202 3202 3202 3202 3202 3202 3202 3202 3202 3202 3202
3202 3202 3202 3202 3202 3202 3202 3202 3202 3202 3202 3202 3202 3202 3202 3202 3202 3200 3200 5001 5002 5003 5004 5005 5006 5007 3200 3202 3202 3202 3202 3202 3200 5015 5016 5017 5018 5019 3202 3202 3202 3202 3202 3202 3202 3202 3202 3202 3202 3200 3200 3202 3202 3202 3202 3202 3202 3202 3202 3202 3202 3202 3202 3202 3202 3202 3202 3202
3202 3202 3202 3202 3202 3202 3202 3202 3202 3202 3202 3202 3202 3202 3202 3202 3202 3200 3200 5101 5102 5103 5104 5105 5106 5107 3200 3202 3202 3202 3202 3202 3200 5115 5116 5117 5118 5119 5120 3202 3202 3202 3202 3202 3202 3202 3202 3202 3202 3200 3200 3202 3202 3202 3202 3202 3202 3202 3202 3202 3202 3202 3202 3202 3202 3202 3202 3202
3202 3202 3202 3202 3202 3202 3202 3202 3202 3202 3202 3202 3202 3202 3202 3202 3202 3200 3200 5201 5202 5203 5204 5205 5206 5207 3200 3202 3202 3202 3202 3202 3200 5215 5216 5217 5218 5219 5220 5221 5222 5223 5224 5225 5226 5227 5228 5229 5230 3200 3200 3202 3202 3202 3202 3202 3202 3202 3202 3202 3202 3202 3202 3202 3202 3202 3202 3202
3202 3202 3202 3202 3202 3202 3202 3202 3202 3202 3202 3202 3202 3202 3202 3202 3202 3200 3200 5301 5302 5303 5304 5305 5306 5307 3200 3202 3202 3202 3202 3202 3200 5315 5316 5317 5318 5319 5320 5321 5322 5323 5324 5325 5326 5327 5328 5329 5330 3200 3200 3202 3202 3202 3202 3202 3202 3202 3202 3202 3202 3202 3202 3202 3202 3202 3202 3202
3202 3202 3202 3202 3202 3202 3202 3202 3202 3202 3202 3202 3202 3202 3202 3202 3202 3200 3200 5401 5402 3202 3202 3202 3202 3202 3202 3202 3202 3202 3202 3202 3200 5415 5416 5417 5418 5419 5420 5421 5422 5423 5424 5425 5426 5427 5428 5429 5430 3200 3200 3202 3202 3202 3202 3202 3202 3202 3202 3202 3202 3202 3202 3202 3202 3202 3202 3202
3202 3202 3202 3202 3202 3202 3202 3202 3202 3202 3202 3202 3202 3202 3202 3202 3202 3200 3200 5501 5502 3202 3202 3202 3202 3202 3202 3202 3202 3202 3202 3202 3200 5515 5516 5517 5518 5519 5520 5521 5522 5523 5524 5525 5526 5527 5528 5529 5530 3200 3200 3202 3202 3202 3202 3202 3202 3202 3202 3202 3202 3202 3202 3202 3202 3202 3202 3202
3202 3202 3202 3202 3202 3202 3202 3202 3202 3202 3202 3202 3202 3202 3202 3202 3202 3200 3200 5601 5602 5603 3202 3202 3202 3202 3202 3202 3202 3202 3202 3202 3200 5615 5616 5617 5618 5619 5620 5621 5622 5623 5624 5625 5626 5627 5628 5629 5630 3200 3200 3202 3202 3202 3202 3202 3202 3202 3202 3202 3202 3202 3202 3202 3202 3202 3202 3202
3202 3202 3202 3202 3202 3202 3202 3202 3202 3202 3202 3202 3202 3202 3202 3202 3202 3200 3200 5701 5702 5703 3202 3202 3202 3202 3202 3202 3202 3202 3202 3202 3200 5715 5716 5717 5718 5719 5720 5721 5722 5723 5724 5725 5726 5727 5728 5729 5730 3200 3200 3202 3202 3202 3202 3202 3202 3202 3202 3202 3202 3202 3202 3202 3202 3202 3202 3202
3202 3202 3202 3202 3202 3202 3202 3202 3202 3202 3202 3202 3202 3202 3202 3202 3202 3200 3200 5801 5802 5803 3202 3202 3202 3202 3202 3202 3202 3202 3202 3202 3200 7101 7102 7101 7102 7101 7102 7101 7102 7101 7102 7101 7102 7101 5928 5829 5830 3200 3200 3202 3202 3202 3202 3202 3202 3202 3202 3202 3202 3202 3202 3202 3202 3202 3202 3202
3202 3202 3202 3202 3202 3202 3202 3202 3202 3202 3202 3202 3202 3202 3202 3202 3202 3200 3200 5901 5902 3202 3202 3202 3202 3202 3202 3202 3202 3202 3202 3202 3200 7103 7104 7103 7104 7103 7104 7103 7104 7103 7104 7103 7104 7103 5828 5929 5930 3200 3200 3202 3202 3202 3202 3202 3202 3202 3202 3202 3202 3202 3202 3202 3202 3202 3202 3202
3202 3202 3202 3202 3202 3202 3202 3202 3202 3202 3202 3202 3202 3202 3202 3202 3202 3200 3200 6001 6002 6003 3202 3202 3202 3202 3202 3202 3202 3202 3202 3202 3200 7101 7102 7101 7102 7101 7102 7101 7102 7101 7102 7101 7102 7101 5928 6029 6030 3200 3200 3202 3202 3202 3202 3202 3202 3202 3202 3202 3202 3202 3202 3202 3202 3202 3202 3202
3202 3202 3202 3202 3202 3202 3202 3202 3202 3202 3202 3202 3202 3202 3202 3202 3202 3200 3200 6101 6102 6103 3202 3202 3202 3202 3202 3202 3200 6111 6112 6113 6114 7103 7104 7103 7104 7103 7104 7103 7104 7103 7104 7103 7104 7103 5828 6129 6130 3200 3200 3202 3202 3202 3202 3202 3202 3202 3202 3202 3202 3202 3202 3202 3202 3202 3202 3202
3202 3202 3202 3202 3202 3202 3202 3202 3202 3202 3202 3202 3202 3202 3202 3202 3202 3200 3200 6201 6202 6203 3202 3202 3202 3202 3202 3202 3200 6211 6212 6213 6214 7101 7102 7101 7102 7101 7102 7101 7102 7101 7102 7101 7102 7101 5928 6229 6230 3200 3200 3202 3202 3202 3202 3202 3202 3202 3202 3202 3202 3202 3202 3202 3202 3202 3202 3202
3202 3202 3202 3202 3202 3202 3202 3202 3202 3202 3202 3202 3202 3202 3202 3202 3202 3200 3200 6301 6302 6303 3202 3202 3202 3202 3202 3202 3201 6311 6312 6313 6314 7103 7104 7103 7104 7103 7104 7103 7104 7103 7104 7103 7104 7103 5828 6329 6330 3200 3200 3202 3202 3202 3202 3202 3202 3202 3202 3202 3202 3202 3202 3202 3202 3202 3202 3202
3202 3202 3202 3202 3202 3202 3202 3202 3202 3202 3202 3202 3202 3202 3202 3202 3202 3200 3200 3202 3202 3202 3202 3202 3202 3202 3202 3202 3202 3202 3202 6413 3200 6415 7102 7101 6418 3200 3200 3200 3200 6423 6424 6425 6426 6427 6428 3200 3200 3200 3200 3202 3202 3202 3202 3202 3202 3202 3202 3202 3202 3202 3202 3202 3202 3202 3202 3202
3202 3202 3202 3202 3202 3202 3202 3202 3202 3202 3202 3202 3202 3202 3202 3202 3202 3200 3200 3202 3202 3202 3202 3202 3202 3202 3202 3202 3202 3202 3202 3202 3200 6515 7104 7103 6518 3200 3200 3200 3200 6523 6524 6525 6526 6527 6528 3999 3200 3200 3200 3202 3202 3202 3202 3202 3202 3202 3202 3202 3202 3202 3202 3202 3202 3202 3202 3202
3202 3202 3202 3202 3202 3202 3202 3202 3202 3202 3202 3202 3202 3202 3202 3202 3202 3200 3200 3202 3202 3202 3202 3202 3202 3202 3202 3202 3202 3202 3202 3202 3201 6615 7102 7101 6618 3201 3201 3201 3201 6623 6624 6625 6626 6627 6628 3201 3201 3200 3200 3202 3202 3202 3202 3202 3202 3202 3202 3202 3202 3202 3202 3202 3202 3202 3202 3202
3202 3202 3202 3202 3202 3202 3202 3202 3202 3202 3202 3202 3202 3202 3202 3202 3202 3200 3200 6701 6702 3202 3202 3202 3202 3202 3202 3202 3202 3202 3202 3202 3202 3202 3202 3202 3202 3202 3202 3202 3202 3202 3202 3202 3202 3202 3202 3202 3202 3200 3200 3202 3202 3202 3202 3202 3202 3202 3202 3202 3202 3202 3202 3202 3202 3202 3202 3202
3202 3202 3202 3202 3202 3202 3202 3202 3202 3202 3202 3202 3202 3202 3202 3202 3202 3200 3200 6801 6802 3202 3202 3202 3202 3202 3202 3202 3202 3202 3202 3202 3202 3202 3202 3202 3202 3202 3202 3202 3202 3202 3202 3202 3202 3202 3202 3202 3202 3200 3200 3202 3202 3202 3202 3202 3202 3202 3202 3202 3202 3202 3202 3202 3202 3202 3202 3202
3202 3202 3202 3202 3202 3202 3202 3202 3202 3202 3202 3202 3202 3202 3202 3202 3202 3200 3200 6901 6902 3202 3202 3202 3202 3202 3202 3202 3202 3202 3202 3202 3202 3202 3202 3202 3202 3202 3202 3202 3202 3202 3202 3202 3202 3202 3202 3202 3202 3200 3200 3202 3202 3202 3202 3202 3202 3202 3202 3202 3202 3202 3202 3202 3202 3202 3202 3202
3202 3202 3202 3202 3202 3202 3202 3202 3202 3202 3202 3202 3202 3202 3202 3202 3202 3200 3200 7001 7002 3202 3202 3202 3202 3202 3202 3202 3202 3202 3202 3202 3202 3202 3202 3202 3202 3202 3202 3202 3202 3202 3202 3202 3202 3202 3202 3202 3202 3200 3200 3202 3202 3202 3202 3202 3202 3202 3202 3202 3202 3202 3202 3202 3202 3202 3202 3202
3202 3202 3202 3202 3202 3202 3202 3202 3202 3202 3202 3202 3202 3202 3202 3202 3202 3200 3200 3200 3200 3200 3200 3200 3200 3200 3200 3200 3200 3200 3200 3200 3200 3200 3200 3200 3200 3200 3200 3200 3200 3200 3200 3200 3200 3200 3200 3200 3200 3200 3200 3202 3202 3202 3202 3202 3202 3202 3202 3202 3202 3202 3202 3202 3202 3202 3202 3202
3202 3202 3202 3202 3202 3202 3202 3202 3202 3202 3202 3202 3202 3202 3202 3202 3202 3200 3200 3200 3200 3200 3200 3200 3200 3200 3200 3200 3200 3200 3200 3200 3200 3200 3200 3200 3200 3200 3200 3200 3200 3200 3200 3200 3200 3200 3200 3200 3200 3200 3200 3202 3202 3202 3202 3202 3202 3202 3202 3202 3202 3202 3202 3202 3202 3202 3202 3202
3202 3202 3202 3202 3202 3202 3202 3202 3202 3202 3202 3202 3202 3202 3202 3202 3202 3202 3202 3202 3202 3202 3202 3202 3202 3202 3202 3202 3202 3202 3202 3202 3202 3202 3202 3202 3202 3202 3202 3202 3202 3202 3202 3202 3202 3202 3202 3202 3202 3202 3202 3202 3202 3202 3202 3202 3202 3202 3202 3202 3202 3202 3202 3202 3202 3202 3202 3202
3202 3202 3202 3202 3202 3202 3202 3202 3202 3202 3202 3202 3202 3202 3202 3202 3202 3202 3202 3202 3202 3202 3202 3202 3202 3202 3202 3202 3202 3202 3202 3202 3202 3202 3202 3202 3202 3202 3202 3202 3202 3202 3202 3202 3202 3202 3202 3202 3202 3202 3202 3202 3202 3202 3202 3202 3202 3202 3202 3202 3202 3202 3202 3202 3202 3202 3202 3202
3202 3202 3202 3202 3202 3202 3202 3202 3202 3202 3202 3202 3202 3202 3202 3202 3202 3202 3202 3202 3202 3202 3202 3202 3202 3202 3202 3202 3202 3202 3202 3202 3202 3202 3202 3202 3202 3202 3202 3202 3202 3202 3202 3202 3202 3202 3202 3202 3202 3202 3202 3202 3202 3202 3202 3202 3202 3202 3202 3202 3202 3202 3202 3202 3202 3202 3202 3202
3202 3202 3202 3202 3202 3202 3202 3202 3202 3202 3202 3202 3202 3202 3202 3202 3202 3202 3202 3202 3202 3202 3202 3202 3202 3202 3202 3202 3202 3202 3202 3202 3202 3202 3202 3202 3202 3202 3202 3202 3202 3202 3202 3202 3202 3202 3202 3202 3202 3202 3202 3202 3202 3202 3202 3202 3202 3202 3202 3202 3202 3202 3202 3202 3202 3202 3202 3202
3202 3202 3202 3202 3202 3202 3202 3202 3202 3202 3202 3202 3202 3202 3202 3202 3202 3202 3202 3202 3202 3202 3202 3202 3202 3202 3202 3202 3202 3202 3202 3202 3202 3202 3202 3202 3202 3202 3202 3202 3202 3202 3202 3202 3202 3202 3202 3202 3202 3202 3202 3202 3202 3202 3202 3202 3202 3202 3202 3202 3202 3202 3202 3202 3202 3202 3202 3202
3202 3202 3202 3202 3202 3202 3202 3202 3202 3202 3202 3202 3202 3202 3202 3202 3202 3202 3202 3202 3202 3202 3202 3202 3202 3202 3202 3202 3202 3202 3202 3202 3202 3202 3202 3202 3202 3202 3202 3202 3202 3202 3202 3202 3202 3202 3202 3202 3202 3202 3202 3202 3202 3202 3202 3202 3202 3202 3202 3202 3202 3202 3202 3202 3202 3202 3202 3202
3202 3202 3202 3202 3202 3202 3202 3202 3202 3202 3202 3202 3202 3202 3202 3202 3202 3202 3202 3202 3202 3202 3202 3202 3202 3202 3202 3202 3202 3202 3202 3202 3202 3202 3202 3202 3202 3202 3202 3202 3202 3202 3202 3202 3202 3202 3202 3202 3202 3202 3202 3202 3202 3202 3202 3202 3202 3202 3202 3202 3202 3202 3202 3202 3202 3202 3202 3202
3202 3202 3202 3202 3202 3202 3202 3202 3202 3202 3202 3202 3202 3202 3202 3202 3202 3202 3202 3202 3202 3202 3202 3202 3202 3202 3202 3202 3202 3202 3202 3202 3202 3202 3202 3202 3202 3202 3202 3202 3202 3202 3202 3202 3202 3202 3202 3202 3202 3202 3202 3202 3202 3202 3202 3202 3202 3202 3202 3202 3202 3202 3202 3202 3202 3202 3202 3202
3202 3202 3202 3202 3202 3202 3202 3202 3202 3202 3202 3202 3202 3202 3202 3202 3202 3202 3202 3202 3202 3202 3202 3202 3202 3202 3202 3202 3202 3202 3202 3202 3202 3202 3202 3202 3202 3202 3202 3202 3202 3202 3202 3202 3202 3202 3202 3202 3202 3202 3202 3202 3202 3202 3202 3202 3202 3202 3202 3202 3202 3202 3202 3202 3202 3202 3202 3202